0 0 0 0 0 0 0 0 0 0 0 0 0 0 0 0 0 0 0 0 0 0 0 0 0 0 0 0 0 0 0 0 0 0 0 0 0 0 0 0 0 0 0 0 0 0 0 0 0 0 0 0 0 0 0 0 0 0 0 0 0 0 0 0 0 0 0 0 0 0 0 0 0 0 0 0 0 0 0 0
0 0 0 0 0 0 0 0 0 0 0 0 0 0 0 0 0 0 0 0 0 0 0 0 0 0 0 0 0 0 0 0 0 0 0 0 0 0 0 0 0 0 0 0 0 0 0 0 0 0 0 0 0 0 0 0 0 0 0 0 0 0 0 0 0 0 0 0 0 0 0 0 0 0 0 0 0 0 0 0
0 0 0 0 2 2 2 2 2 2 2 2 2 2 2 2 2 2 2 2 2 2 2 2 2 0 0 0 0 2 2 2 2 2 2 2 2 2 2 2 2 2 2 2 2 2 2 2 2 2 2 2 0 0 0 0 0 0 0 0 0 0 0 2 2 2 2 2 2 2 2 2 2 2 2 2 2 0 0 0
0 0 0 0 2 1 1 1 1 1 1 1 1 1 1 1 1 1 1 1 1 1 1 1 2 0 0 0 0 2 1 1 1 1 1 1 1 1 1 1 1 1 1 1 1 1 1 1 1 1 1 2 0 0 0 0 0 0 0 0 0 0 0 2 1 1 1 1 1 1 1 1 1 1 1 1 1 2 0 0
0 0 0 0 2 1 1 1 1 1 1 1 1 1 1 1 1 1 1 1 1 1 1 1 2 0 0 0 0 2 1 1 1 1 1 1 1 1 1 1 1 1 1 5303 5303 5303 1 1 1 1 1 2 0 0 0 0 0 0 0 0 0 0 0 2 1 1 1 1 1 1 1 1 1 1 1 1 1 2 0 0
0 0 0 0 2 1 7 1 1 1 4 4 1 4 4 1 1 4 4 1 1 7 1 1 2 0 0 0 0 2 1 1 7 1 1 1 1 1 1 7 1 1 5305 9 9 9 5304 5303 1 1 1 2 0 0 0 0 0 0 0 0 0 0 0 2 1 1 1 1 1 1 1 1 1 1 1 1 1 2 0 0
0 0 0 0 2 1 1 1 5 4 4 4 4 4 4 5 4 4 4 4 1 1 1 1 2 0 0 0 0 2 1 1 1 1 1 1 1 1 1 1 1 5305 9 9 9 9 9 9 5304 1 1 2 0 0 0 2 2 2 2 2 2 2 2 2 1 1 1 1 7 1 1 1 1 1 1 1 1 2 0 0
0 0 0 0 2 1 1 1 4 4 4 4 5 4 4 4 4 4 5 4 1 1 1 1 2 0 0 0 0 2 1 1 1 1 1 1 1 1 1 1 530800 9 9 9 9 9 9 9 9 5301 1 2 0 0 0 2 1 1 1 1 1 1 1 1 1 1 1 1 1 1 1 1 1 8 89 1 1 2 0 0
0 0 0 0 2 1 1 1 4 4 5 4 4 4 4 4 5 4 4 4 4 1 7 1 2 0 0 0 0 2 1 1 1 1 1 7 1 1 1 1 530800 9 9 9 9 9 9 9 9 5301 1 2 0 0 0 2 1 1 1 1 1 1 1 1 1 1 1 1 1 1 1 1 1 88 88 1 1 2 0 0
0 0 0 0 2 1 1 4 4 4 4 4 4 4 4 4 4 4 4 4 5 1 1 1 2 0 0 0 0 2 1 1 1 1 1 1 1 1 1 1 1 5308 9 9 9 9 9 9 9 5301 1 2 0 0 0 2 1 1 1 7 1 1 1 1 1 1 1 1 1 1 1 1 1 1 99 1 1 2 0 0
0 0 0 0 2 1 1 4 4 4 4 4 4 4 4 4 4 4 4 4 1 1 1 1 2 0 0 0 0 2 1 1 1 1 1 1 1 1 1 1 1 1 5308 9 9 9 9 9 5307 1 1 2 0 0 0 2 1 1 1 1 1 1 1 7 1 1 1 1 1 1 1 1 1 1 1 1 1 2 0 0
0 0 0 0 2 1 1 1 4 5 4 4 4 5 4 4 5 4 4 4 1 1 1 1 2 0 0 0 0 2 1 1 1 1 1 1 1 1 1 1 1 5303 5305 9 9 9 9 9 9 5301 1 2 0 0 0 2 1 1 1 1 1 1 1 1 1 1 1 1 1 1 1 1 1 1 1 1 1 2 0 0
0 0 0 0 2 1 1 1 4 4 4 4 4 4 4 4 4 4 5 4 4 1 1 1 2 0 0 0 0 2 2 2 1 1 1 1 1 1 1 1 530800 9 9 9 9 9 9 9 5300 1 1 2 0 0 0 2 1 1 1 1 1 1 1 1 1 1 1 1 1 1 1 1 1 1 1 1 1 2 0 0
0 0 0 0 2 1 1 4 4 4 4 4 4 4 4 4 4 4 4 4 1 1 7 1 2 0 0 0 0 0 0 2 1 1 1 1 1 1 1 1 1 5309 5308 9 9 5300 5308 9 5301 1 1 2 0 0 0 2 2 2 2 2 2 2 1 1 1 1 1 1 1 1 1 1 1 7 1 1 1 2 0 0
0 0 0 0 2 1 1 1 1 4 4 1 4 5 4 1 4 4 1 1 1 1 1 1 2 0 0 0 0 0 0 2 1 1 1 1 7 1 1 1 1 1 1 5309 5309 1 1 5309 1 1 1 2 0 0 0 0 0 0 0 0 0 2 1 1 1 1 1 1 7 1 1 1 1 1 1 1 1 2 0 0
0 0 0 0 2 1 1 7 1 1 1 1 1 4 1 1 1 1 1 1 1 1 1 1 2 0 0 0 0 0 0 2 1 1 1 1 1 1 1 1 1 1 1 1 1 1 1 1 1 1 1 2 0 0 0 0 0 0 0 0 0 2 1 1 1 1 1 1 1 1 1 1 1 1 1 1 1 2 0 0
0 0 0 0 2 1 1 1 1 1 1 1 1 1 1 1 1 1 1 1 1 1 1 1 2 0 0 0 0 0 0 2 1 1 1 1 1 1 1 1 1 1 1 1 1 1 1 1 1 7 1 2 0 0 0 0 0 0 0 0 0 2 1 1 1 1 1 1 1 1 1 1 1 1 1 1 1 2 0 0
0 0 0 2 2 1 1 1 1 1 1 1 1 1 1 1 1 1 1 1 1 1 1 1 2 0 0 0 0 0 0 2 1 1 1 1 1 1 1 1 1 1 1 1 1 1 1 1 1 1 1 2 0 0 0 0 0 0 0 0 0 2 1 1 1 1 1 1 1 1 1 1 1 1 1 1 1 2 0 0
0 0 2 1 1 1 1 1 1 1 1 1 1 7 1 1 1 1 1 1 1 1 1 1 2 2 2 2 2 2 2 2 1 1 1 1 1 1 1 1 1 7 1 1 1 1 1 1 1 1 1 2 0 0 0 0 0 0 0 0 0 2 1 1 1 1 1 1 1 1 1 1 1 1 1 1 1 2 0 0
0 0 2 1 1 1 7 1 1 1 1 1 1 1 1 1 1 1 1 1 1 1 1 1 1 1 1 1 1 1 1 1 1 1 1 1 1 1 1 1 1 1 1 1 1 1 1 1 1 1 1 2 0 0 0 0 0 0 0 0 0 2 1 1 1 1 1 1 1 1 4 4 5 1 1 2 2 0 0 0
0 0 2 1 1 1 1 1 1 1 1 1 1 1 1 1 1 1 1 7 1 1 1 1 1 1 1 1 1 1 1 1 1 1 7 1 1 1 1 1 1 1 1 1 1 1 1 1 1 1 1 2 0 0 0 0 0 0 0 0 0 2 1 1 1 7 1 1 1 4 4 4 4 4 1 2 0 0 0 0
0 0 2 1 1 1 1 1 1 1 1 1 1 1 1 1 1 1 1 1 1 1 1 1 1 1 1 1 1 7 1 1 1 1 1 1 1 1 1 1 1 1 1 1 5 6 6 6 1 1 1 2 0 0 0 0 0 0 0 0 0 2 1 1 1 1 1 1 4 5 4 4 4 1 1 2 0 0 0 0
0 0 2 1 7 1 1 1 1 1 1 6 6 6 5 1 1 1 1 1 1 1 1 1 1 1 1 1 1 1 1 1 1 1 1 1 1 1 1 1 1 1 1 1 6 6 6 5 1 1 1 2 0 0 0 0 0 0 0 2 2 2 1 1 1 1 1 1 4 4 4 5 4 1 1 2 0 0 0 0
0 0 2 1 1 1 1 1 1 1 1 6 5 6 6 1 1 1 1 1 1 1 1 7 1 1 1 1 1 1 1 1 1 1 1 1 1 1 1 1 1 1 1 1 6 5 6 6 1 7 1 2 0 0 0 2 2 2 2 2 1 1 1 1 1 1 1 1 1 4 4 4 4 4 1 2 0 0 0 0
0 0 2 1 1 1 1 7 1 1 1 6 6 6 6 1 1 1 1 1 1 1 1 1 1 1 1 1 1 1 1 1 1 1 1 1 1 1 1 1 1 1 1 1 6 6 6 5 1 1 1 2 0 0 0 2 1 1 1 1 1 1 1 1 1 1 1 1 1 4 5 4 4 5 1 2 0 0 0 0
0 0 2 1 1 1 1 1 1 1 1 6 6 5 6 1 1 1 7 1 1 1 1 1 1 1 1 1 1 1 1 7 1 1 1 1 1 1 1 1 1 1 1 1 1 1 1 1 1 1 1 2 0 0 0 2 1 1 1 1 1 7 1 1 1 1 1 1 1 4 4 4 4 1 1 2 0 0 0 0
0 0 2 2 2 2 2 2 2 1 1 5 6 6 5 1 1 1 1 1 1 1 1 1 1 1 1 1 1 1 1 1 1 1 1 1 1 1 7 1 1 1 1 1 1 1 1 1 1 1 1 2 0 0 0 2 1 1 1 1 1 1 1 1 1 1 1 1 4 5 4 4 5 1 1 2 0 0 0 0
0 0 0 0 0 0 0 0 2 1 1 1 1 1 1 1 1 1 1 1 1 1 1 1 1 1 1 1 1 1 1 1 1 1 1 1 1 1 1 1 1 1 1 1 1 1 1 1 1 1 1 2 0 0 0 2 1 1 1 1 1 1 1 1 1 1 1 1 1 1 4 4 1 1 1 2 0 0 0 0
0 0 0 0 0 0 0 0 2 1 1 1 1 1 1 1 1 1 1 1 1 1 7 1 1 1 1 7 1 1 1 1 1 7 1 1 1 1 1 1 1 1 1 1 2 2 2 2 2 2 2 2 0 0 0 2 1 1 6 6 6 1 1 1 1 1 1 1 1 1 1 1 1 1 1 2 0 0 0 0
0 0 0 0 0 0 0 0 2 1 1 1 1 1 1 1 1 1 1 1 1 1 1 1 1 1 1 1 1 1 1 1 1 1 1 1 1 1 1 1 1 7 1 1 2 0 0 0 0 0 0 0 0 0 0 2 1 1 6 5 6 1 1 1 1 1 1 1 1 1 1 1 1 1 1 2 0 0 0 0
0 0 0 0 0 0 0 0 2 1 1 7 1 1 1 1 1 1 1 1 1 2 2 2 2 2 2 2 2 2 2 2 2 2 2 2 2 1 1 1 1 1 1 1 2 0 0 0 0 0 0 0 0 0 0 2 1 1 5 6 6 1 1 1 1 1 1 1 1 1 1 1 7 1 1 2 0 0 0 0
0 0 0 0 0 0 0 0 2 1 1 1 1 1 7 1 1 1 1 1 1 2 0 0 0 0 0 0 0 0 0 0 0 0 0 0 2 1 1 1 1 1 1 1 2 0 0 0 0 0 0 0 0 0 0 2 1 1 6 6 5 1 1 1 1 1 1 1 1 1 1 1 1 1 1 2 0 0 0 0
0 0 0 0 0 0 0 0 2 1 1 1 1 1 1 1 1 1 1 7 1 2 0 0 0 0 0 0 0 0 0 0 0 0 0 0 2 1 1 1 1 1 1 1 2 0 0 0 0 0 0 0 0 0 0 2 1 1 1 1 1 1 7 1 1 1 1 1 1 1 1 1 1 1 1 2 0 0 0 0
0 0 0 0 0 0 0 0 2 1 1 1 1 1 5303 1 1 1 1 1 1 2 0 0 0 0 0 0 0 0 0 0 0 0 0 0 2 1 1 1 1 1 1 1 2 0 0 0 0 0 0 0 0 0 0 2 1 1 1 1 1 1 1 1 1 1 1 1 1 1 1 1 1 1 1 2 0 0 0 0
0 0 0 0 0 0 0 0 2 1 1 1 5303 530800 9 5304 1 5303 1 1 1 2 0 0 0 0 0 0 0 0 0 0 0 0 0 0 2 1 1 1 1 1 1 1 2 0 0 0 0 0 0 0 0 0 0 2 1 1 1 1 1 1 1 1 1 1 1 1 1 1 1 1 1 1 1 2 0 0 0 0
0 0 0 0 0 0 0 0 2 1 1 5305 9 5310 9 9 5310 9 5304 1 1 2 0 0 0 0 0 0 0 0 0 0 0 0 0 0 2 1 1 1 1 1 1 1 2 0 0 0 0 0 0 0 0 0 0 2 1 1 1 7 1 1 1 1 1 1 1 1 1 1 1 1 1 1 1 2 0 0 0 0
0 0 0 0 0 0 0 0 2 1 5305 9 9 9 9 9 9 9 9 5301 1 2 0 0 0 0 0 0 0 0 0 0 0 0 0 0 2 1 7 1 1 1 1 1 2 2 2 2 2 2 2 2 2 2 2 2 1 1 1 1 1 1 1 1 1 1 1 1 1 7 1 1 1 1 1 2 0 0 0 0
0 0 0 0 0 0 0 0 2 530800 9 9 9 9 9 9 9 9 9 5304 1 2 0 0 0 0 0 0 0 0 0 0 0 0 0 0 2 1 1 1 1 1 1 1 1 1 1 1 1 1 1 1 1 1 1 1 1 1 1 1 1 1 1 1 1 1 1 1 1 1 1 1 1 1 1 2 0 0 0 0
0 0 0 0 0 0 0 0 2 1 5308 9 9 9 9 9 9 9 9 9 5301 2 0 0 0 2 2 2 2 2 2 2 2 2 2 2 2 1 1 1 1 1 1 1 1 1 1 7 1 1 1 1 1 1 1 1 1 1 1 1 1 1 1 1 1 1 1 1 1 1 1 1 1 1 1 2 0 0 0 0
0 0 0 0 2 2 2 2 2 1 5305 9 9 9 9 9 9 9 9 5300 1 2 0 0 0 2 1 1 1 1 1 1 1 1 1 1 1 1 1 1 1 1 1 1 1 1 1 1 1 1 1 1 1 1 1 1 1 1 1 1 1 1 1 1 1 1 1 1 1 1 1 1 1 1 1 2 0 0 0 0
0 0 0 0 2 1 1 1 1 530800 9 9 9 9 9 9 9 9 9 5301 1 2 0 0 0 2 1 1 1 1 1 1 1 1 1 1 1 1 1 1 1 1 7 1 1 1 1 1 1 1 1 1 1 1 1 1 1 1 1 1 1 1 1 1 1 1 1 1 5303 5303 5303 5303 1 1 1 2 0 0 0 0
0 0 0 0 2 1 1 1 1 1 5308 9 9 9 9 9 9 9 9 5301 1 2 0 0 0 2 1 1 1 1 4 4 1 1 1 1 1 1 1 1 1 1 1 1 1 1 1 1 1 1 1 1 1 1 1 1 1 1 1 1 1 1 1 1 1 1 1 5305 9 9 9 9 5301 1 1 2 0 0 0 0
0 0 0 0 2 1 1 1 1 1 1 5308 9 9 5300 5308 9 9 5300 1 1 2 0 0 0 2 1 1 4 4 5 4 4 5 4 1 1 1 1 1 1 1 1 1 1 1 1 1 1 1 1 1 1 1 7 1 1 1 1 1 1 1 7 1 1 1 530800 9 9 9 9 9 5304 1 1 2 0 0 0 0
0 0 0 0 2 1 1 1 1 1 1 1 5309 5309 1 1 5309 5309 1 1 1 2 0 0 0 2 1 1 1 4 4 4 4 4 5 4 1 1 7 1 1 1 1 1 1 1 1 1 7 1 1 1 1 1 1 1 1 1 1 1 1 1 1 1 1 1 5305 9 9 9 9 9 9 5301 1 2 0 0 0 0
0 0 0 0 2 2 2 2 2 2 2 2 2 2 2 2 2 2 2 2 2 2 0 0 0 2 1 1 1 5 4 4 5 4 4 4 1 1 1 1 1 1 1 1 1 1 1 1 1 1 1 1 1 1 1 1 1 1 1 1 1 1 1 1 1 530800 9 9 9 9 9 9 9 5304 1 2 0 0 0 0
0 0 0 0 0 0 0 0 0 0 0 0 0 0 0 0 0 0 0 0 0 0 0 0 0 2 1 1 4 4 4 4 4 4 5 1 1 1 1 1 1 1 1 1 1 1 1 1 1 1 1 1 1 1 1 1 1 1 1 1 1 1 1 1 1 530800 9 9 9 9 9 9 9 9 5301 2 0 0 0 0
0 0 0 0 0 0 0 0 0 0 0 0 0 0 0 0 0 0 0 0 0 0 0 0 0 2 1 1 1 1 4 5 1 4 4 1 1 1 1 1 1 1 1 1 1 1 1 1 1 1 1 1 1 1 1 1 1 1 1 1 1 1 1 1 1 1 5308 9 9 9 9 9 9 5300 1 2 0 0 0 0
0 0 0 0 0 0 0 0 0 0 0 0 0 0 0 0 0 0 0 0 0 0 0 0 0 2 1 1 1 1 1 1 1 1 1 1 1 1 1 1 1 1 1 1 1 1 1 1 1 1 1 1 1 1 1 1 1 1 1 1 1 7 1 1 1 1 1 5308 9 9 9 5300 5309 1 1 2 0 0 0 0
0 0 0 0 0 0 0 0 0 0 0 0 0 0 0 0 0 0 0 0 0 0 0 0 0 2 1 1 7 1 1 1 1 1 1 1 1 1 1 1 1 1 1 1 7 1 1 1 1 1 1 1 1 7 1 1 1 1 1 1 1 1 1 1 1 1 1 1 5309 5309 5309 1 1 1 1 2 0 0 0 0
0 0 0 0 0 0 0 0 0 0 0 0 0 0 0 0 0 0 0 0 0 0 0 0 0 2 1 1 1 1 1 1 1 1 1 1 1 1 1 1 1 1 1 1 1 1 1 1 1 1 1 1 1 1 1 1 1 1 1 1 1 1 1 1 1 1 1 1 1 1 1 1 1 1 1 2 0 0 0 0
0 0 2 2 2 2 2 2 2 2 2 2 2 2 2 2 2 2 2 2 2 2 2 2 2 2 1 1 1 1 1 1 7 1 1 1 2 2 2 2 2 2 2 2 2 2 2 2 2 2 2 2 2 2 2 2 2 2 2 2 2 2 2 2 2 2 2 2 2 2 2 2 2 2 2 2 0 0 0 0
0 0 2 1 1 1 1 1 1 1 1 1 1 1 1 1 1 1 1 1 1 1 1 1 1 1 1 1 1 1 1 1 1 1 1 1 2 0 0 0 0 0 0 0 0 0 0 0 0 0 0 0 0 0 0 0 0 0 0 0 0 0 0 0 0 0 0 0 0 0 0 0 0 0 0 0 0 0 0 0
0 0 2 1 1 1 1 1 1 1 1 1 1 1 1 1 1 1 1 1 1 1 1 1 1 1 1 1 1 1 1 1 1 1 1 1 2 0 0 0 0 0 0 0 0 0 0 0 0 0 0 0 0 0 0 0 0 0 0 0 0 0 0 0 0 0 0 0 0 0 0 0 0 0 0 0 0 0 0 0
0 0 2 1 1 1 1 1 1 1 1 1 1 1 1 1 1 1 1 1 1 1 1 1 1 1 1 1 1 1 1 1 1 1 1 1 2 0 0 0 0 0 0 0 0 0 0 0 0 0 0 0 0 0 0 0 0 0 0 0 0 0 0 0 0 0 0 0 0 0 0 0 0 0 0 0 0 0 0 0
0 0 2 1 1 1 1 1 1 1 1 1 1 1 1 1 1 1 1 1 1 1 1 1 1 7 1 1 1 1 1 1 1 1 1 1 2 0 0 0 0 0 0 0 0 0 0 0 0 0 2 2 2 2 2 2 2 2 2 2 2 2 2 2 2 2 2 2 2 2 2 2 0 0 0 0 0 0 0 0
0 0 2 1 1 1 4 4 4 4 1 1 1 7 1 1 1 1 1 1 1 1 1 1 1 1 1 1 1 1 1 1 1 1 1 1 2 2 2 2 2 2 2 0 0 0 0 0 0 0 2 1 1 1 1 1 1 1 1 1 1 1 1 1 1 1 1 1 1 1 1 2 0 0 0 0 0 0 0 0
0 0 2 1 1 1 4 4 4 4 5 1 1 1 1 1 1 1 1 1 1 1 1 1 1 1 1 1 1 1 1 1 1 1 1 1 1 1 1 1 1 1 2 0 0 0 0 0 0 0 2 1 1 1 1 1 1 1 1 1 1 1 1 1 1 1 1 1 1 1 1 2 0 0 0 0 0 0 0 0
0 0 2 1 1 4 5 4 4 4 4 1 1 1 1 1 1 1 1 7 1 1 1 1 1 1 1 1 1 1 1 1 1 1 1 1 1 1 1 1 1 1 2 0 0 0 0 0 0 0 2 1 1 1 1 1 1 1 7 1 1 1 1 1 1 7 1 1 1 1 1 2 0 0 0 0 0 0 0 0
0 0 2 1 1 4 4 4 5 4 1 1 1 1 1 1 1 1 1 1 1 1 1 1 1 1 1 1 1 1 1 1 1 1 1 1 1 5303 1 1 1 1 2 0 0 0 0 0 0 0 2 1 1 7 1 1 1 1 1 1 1 1 1 1 1 1 1 1 1 88 88 2 0 0 0 0 0 0 0 0
0 0 2 1 1 1 4 4 4 4 1 1 1 1 1 1 1 1 1 1 1 1 1 1 1 1 1 1 1 1 1 1 1 1 1 1 5305 9 5304 1 1 1 2 0 0 0 0 0 0 0 2 1 1 1 1 1 1 1 1 1 1 1 1 1 1 1 1 8 89 1 1 2 0 0 0 0 0 0 0 0
0 0 2 1 1 1 4 4 4 1 1 1 1 1 1 1 1 1 1 1 1 1 1 1 1 1 1 1 1 1 1 1 1 1 1 5305 9 9 9 5304 1 1 2 0 0 0 0 0 0 0 2 1 1 1 1 1 1 1 1 1 1 1 1 2 2 2 2 2 2 2 2 2 2 2 2 2 2 2 0 0
0 0 2 1 1 1 4 4 4 4 1 1 1 1 1 7 1 1 1 1 1 1 1 1 1 1 1 1 1 1 7 1 1 1 530800 9 9 9 9 9 5304 1 2 0 0 0 0 0 0 0 2 1 1 1 1 1 1 1 1 1 1 1 1 2 0 0 0 0 0 0 0 0 0 0 0 0 0 2 0 0
0 0 2 1 1 4 5 4 4 4 4 1 1 1 1 1 1 1 1 1 1 1 1 1 1 1 1 1 1 1 1 1 1 1 530800 9 9 9 9 9 9 5301 2 0 0 0 0 2 2 2 2 1 1 1 1 1 1 1 1 1 1 1 1 2 0 0 0 0 0 0 0 0 0 0 0 0 0 2 0 0
0 0 2 1 1 1 4 4 4 4 5 1 1 1 1 1 1 1 1 1 1 1 1 1 5 6 6 1 1 1 1 1 1 1 1 5308 9 9 9 9 9 5301 2 0 0 0 0 2 1 1 1 1 1 1 1 7 1 1 1 1 1 7 1 2 0 0 0 0 0 0 0 0 0 0 0 0 0 2 0 0
0 0 2 1 1 1 4 4 5 4 1 1 1 1 1 1 1 1 1 1 1 1 1 1 6 5 6 1 1 1 1 1 1 1 1 5305 9 9 9 9 5307 1 2 0 0 0 0 2 1 1 1 1 1 1 1 1 1 1 1 1 1 1 1 2 0 0 0 0 0 0 0 0 0 0 0 0 0 2 0 0
0 0 2 1 1 4 4 4 4 4 1 7 1 1 1 1 1 2 2 2 2 2 1 1 5 6 6 1 1 1 1 1 1 1 530800 9 9 9 9 9 9 5301 2 0 0 0 0 2 1 1 1 1 1 1 1 1 1 1 1 1 1 1 1 2 0 0 0 0 0 0 0 0 0 0 0 0 0 2 0 0
0 0 2 1 1 1 5 4 4 4 1 1 1 1 1 1 1 2 0 0 0 2 1 1 6 6 5 1 1 1 1 1 1 1 530800 9 9 9 9 9 9 5301 2 0 0 0 0 2 1 1 1 7 1 1 1 1 5 6 6 5 1 1 1 2 0 0 0 0 0 0 0 0 0 0 0 0 0 2 0 0
0 0 2 1 1 1 4 4 5 4 4 1 1 1 1 1 1 2 0 0 0 2 1 1 5 6 6 1 1 1 1 1 1 1 1 5308 9 9 9 9 5300 1 2 0 0 0 0 2 1 1 1 1 1 1 1 1 6 6 6 6 1 1 1 2 0 0 0 0 0 0 0 0 0 0 0 0 0 2 0 0
0 0 2 1 1 1 4 4 4 4 4 1 1 1 1 1 1 2 0 0 0 2 1 1 1 1 1 1 1 1 1 7 1 1 1 1 5308 9 9 5300 1 1 2 0 0 0 0 2 1 1 1 1 1 1 1 1 6 6 5 6 1 1 1 2 0 0 0 0 0 0 0 0 0 0 0 0 0 2 0 0
0 0 2 1 1 4 4 5 4 4 1 1 1 1 1 1 1 2 0 0 0 2 1 1 1 1 1 1 1 1 1 1 1 1 1 1 1 5309 5309 1 1 1 2 0 0 0 0 2 1 1 1 1 1 1 1 1 6 5 6 6 1 1 1 2 0 0 0 0 0 0 0 0 0 0 0 0 0 2 0 0
0 0 2 1 1 1 4 4 1 1 1 1 1 1 1 1 1 2 0 0 0 2 1 1 7 1 1 1 1 1 1 1 1 1 1 1 1 1 1 1 1 1 2 0 0 0 0 2 1 1 1 1 1 1 1 1 6 6 6 5 1 1 1 2 0 0 0 0 0 0 0 0 0 0 0 0 0 2 0 0
0 0 2 1 1 1 1 1 1 1 1 1 1 1 7 1 1 2 0 0 0 2 1 1 1 1 1 1 1 1 1 1 1 1 1 1 1 1 1 1 1 2 2 0 0 0 0 2 1 1 1 1 1 1 1 1 1 1 1 1 1 1 1 2 0 0 0 0 0 0 0 0 0 0 0 0 0 2 0 0
0 0 2 1 1 1 1 1 1 1 7 1 1 1 1 1 1 2 0 0 0 2 2 2 2 2 2 2 2 2 1 1 1 1 1 1 1 1 1 1 1 2 0 0 0 0 0 2 1 1 1 1 1 1 1 1 1 1 1 1 1 1 1 2 0 0 0 0 0 0 0 0 0 0 0 0 0 2 0 0
0 0 2 1 1 1 1 1 1 1 1 1 1 1 1 1 1 2 0 0 0 0 0 0 0 0 0 0 0 2 1 1 1 7 1 1 1 1 1 1 1 2 2 2 2 2 2 1 1 1 1 1 1 1 2 2 2 2 2 2 2 2 2 2 0 0 0 0 0 0 0 0 0 0 0 0 0 2 0 0
0 0 2 2 2 2 2 2 1 1 1 1 1 1 1 1 1 2 0 0 0 0 0 0 0 0 0 0 0 2 1 1 1 1 1 1 1 1 1 1 1 1 1 1 1 1 1 1 1 1 1 1 1 1 2 0 0 0 0 0 0 0 0 2 0 0 0 0 0 0 0 0 0 0 0 0 0 2 0 0
0 0 0 0 0 0 0 0 2 2 2 2 2 2 2 2 2 2 0 0 0 0 0 0 0 0 0 0 0 2 1 1 1 1 1 1 1 1 7 1 1 1 1 1 1 1 1 1 1 1 1 7 1 1 2 0 0 0 0 0 0 0 0 2 0 0 0 0 0 0 0 0 0 0 0 0 0 2 0 0
0 0 0 0 0 0 0 0 0 0 0 0 0 0 0 0 0 0 0 0 0 0 0 0 0 0 0 0 0 2 1 1 1 1 1 1 1 1 1 1 1 1 1 1 1 1 1 1 1 1 1 1 1 1 2 0 0 0 0 0 0 0 0 2 0 0 0 0 0 0 0 0 0 0 0 0 0 2 0 0
0 0 0 0 0 0 0 0 0 0 0 0 0 0 0 0 0 0 0 0 0 0 0 0 0 0 0 0 0 2 2 2 2 2 2 2 2 2 2 2 2 1 1 1 1 1 1 1 1 1 1 1 1 1 2 0 0 0 0 0 0 0 0 2 2 2 2 2 2 2 2 2 2 2 2 2 2 2 0 0
0 0 0 0 0 0 0 0 0 0 0 0 0 0 0 0 0 0 0 0 0 0 0 0 0 0 0 0 0 0 0 0 0 0 0 0 0 0 0 0 0 2 2 2 2 2 2 2 2 2 2 2 2 2 2 0 0 0 0 0 0 0 0 0 0 0 0 0 0 0 0 0 0 0 0 0 0 0 0 0
0 0 0 0 0 0 0 0 0 0 0 0 0 0 0 0 0 0 0 0 0 0 0 0 0 0 0 0 0 0 0 0 0 0 0 0 0 0 0 0 0 0 0 0 0 0 0 0 0 0 0 0 0 0 0 0 0 0 0 0 0 0 0 0 0 0 0 0 0 0 0 0 0 0 0 0 0 0 0 0