0 0 0 0 0 0 0 0 0 0 0 0 0 0 0 0 0 0 0 0 0 0 0 0 0 0 0 0 0 0 0 0 0 0 0 0 0 0 0 0 0 0 0 0 0 0 0 0 0 0 0 0 0 0 0 0 0 0 0 0 0 0 0 0 0 0 0 0 0 0 0 0 0 0 0 0 0 0 0 0
0 0 0 0 0 0 0 0 0 0 0 0 0 0 0 0 0 0 0 0 0 0 0 0 0 0 0 0 0 0 0 0 0 0 0 0 0 0 0 0 0 0 0 0 0 0 0 0 0 0 0 0 0 0 0 0 0 0 0 0 0 0 0 0 0 0 0 0 0 0 0 0 0 0 0 0 0 0 0 0
0 0 0 0 0 0 0 0 0 0 0 0 0 0 0 0 0 0 0 0 0 0 0 0 0 0 0 0 0 0 0 0 0 0 0 0 0 0 5253 5252 5252 5252 5252 5259 0 0 0 0 0 0 0 0 0 0 0 0 0 0 0 0 0 0 0 0 0 0 0 0 0 0 0 0 0 0 0 0 0 0 0 0
0 0 0 0 0 0 0 0 0 0 0 0 0 0 0 0 0 0 0 0 0 0 0 0 0 0 0 0 0 0 5253 5252 5252 5252 5252 5259 0 0 5261 1 1 1 1 1 5259 0 0 0 0 0 5253 5252 5259 0 0 0 0 0 0 0 0 0 0 0 0 0 0 0 0 0 0 0 0 0 0 0 0 0 0 0
0 0 0 0 0 0 0 0 0 0 0 0 0 0 0 0 0 0 0 0 0 0 0 0 0 0 0 5253 5252 5252 1 1 1 1 1 1 5252 5252 1 1 1 1 2 1 5260 0 5253 5252 5252 5252 1 1 5260 0 0 0 0 0 0 0 0 0 0 0 0 0 0 0 0 0 0 0 0 0 0 0 0 0 0 0
0 0 0 0 0 0 0 0 0 0 0 0 0 0 0 0 0 0 0 0 0 0 0 0 5253 5252 5252 1 1 1 1 1 1 2 1 1 1 1 1 4 1 1 1 1 1 5252 1 1 1 1 1 1 5260 0 0 0 0 0 0 0 0 0 0 0 0 0 0 0 0 0 0 0 0 0 0 0 0 0 0 0
0 0 0 0 0 0 0 0 0 0 0 0 0 0 0 0 0 0 0 0 0 0 0 0 5261 1 1 2 1 1 2 2 1 1 1 1 1 1 1 1 1 1 1 1 1 1 1 1 1 1 1 1 1 5252 5252 5252 5259 0 0 0 0 0 0 0 0 0 0 0 0 0 0 0 0 0 0 0 0 0 0 0
0 0 0 0 0 0 0 0 0 0 0 0 0 0 0 0 0 0 0 0 0 0 5253 5252 1 1 2 1 1 1 1 1 1 1 2 1 5275 5282 5282 5282 5282 5282 5282 5282 5282 5282 5282 5282 5282 5282 5282 5282 5271 1 1 1 1 5259 0 0 0 0 0 0 0 0 0 0 0 0 0 0 0 0 0 0 0 0 0 0
0 0 0 0 0 0 0 0 0 0 0 0 0 0 0 0 0 0 0 0 5253 5252 1 1 1 1 1 1 1 1 1 1 1 1 1 1 5283 1 1 1 5 1 1 1 1 1 1 1 1 1 1 1 5283 1 1 1 1 1 5252 5252 5252 5252 5259 0 0 0 0 0 0 0 0 0 0 0 0 0 0 0 0 0
0 0 0 0 0 0 0 0 0 0 0 0 0 0 0 0 0 0 5253 5252 1 1 1 1 1 1 1 1 1 1 5 4 1 1 1 1 5283 1 1 1 4 1 1 1 1 2 1 1 1 1 1 1 5283 1 1 2 2 1 1 1 1 1 5260 0 0 0 0 0 0 0 0 0 0 0 0 0 0 0 0 0
0 0 0 0 0 0 0 0 0 0 0 0 0 0 0 0 0 5253 1 1 1 5275 5282 5282 5282 5282 5282 5282 5282 5282 5282 5282 5282 5282 5282 5282 5281 1 5 1 1 1 5 1 2 1 1 1 2 1 1 1 5283 1 1 2 1 1 1 1 1 1 1 5259 0 0 0 0 0 0 0 0 0 0 0 0 0 0 0 0
0 0 0 0 0 0 0 0 0 0 0 0 0 0 0 0 0 5261 1 1 1 5283 1 1 1 1 1 1 1 1 1 1 1 1 1 1 1 1 1 1 1 1 5 1 1 1 1 1 1 1 5 1 5283 1 1 1 1 1 2 1 1 1 1 5260 0 0 0 0 0 0 0 0 0 0 0 0 0 0 0 0
0 0 0 0 0 0 0 0 0 0 0 0 0 0 0 0 5253 1 1 1 1 5283 1 1 1 1 1 1 2 1 1 1 1 1 4 1 1 2 1 1 2 1 1 1 1 1 5 1 1 1 1 1 5283 5 1 1 2 1 2 1 1 2 1 5260 0 0 0 0 0 0 0 0 0 0 0 0 0 0 0 0
0 0 0 0 0 0 0 0 0 0 0 0 0 0 5253 5252 1 1 1 5 1 5283 1 1 1 5 1 2 1 1 1 1 1 1 1 2 1 1 1 1 1 1 2 1 1 1 1 1 5 1 1 1 5283 1 1 1 1 1 1 1 1 1 1 1 5252 5259 0 0 0 0 0 0 0 0 0 0 0 0 0 0
0 0 0 0 0 0 0 0 0 0 0 0 0 0 5261 1 1 1 1 1 1 5283 1 1 1 1 1 1 1 1 1 2 1 1 1 1 1 1 4 1 1 1 1 1 4 1 1 1 1 1 1 1 5283 1 1 1 5 1 1 1 1 89 1 1 1 1 5259 0 0 0 0 0 0 0 0 0 0 0 0 0
0 0 0 0 0 0 0 0 0 0 5253 5252 5252 5252 1 1 2 1 5 1 1 5274 5282 5282 5282 5271 1 1 1 1 1 1 1 1 2 1 1 5 1 1 1 2 1 1 1 1 4 1 1 1 2 1 5283 4 1 1 1 1 1 1 88 88 1 1 5 1 5260 0 0 0 0 0 0 0 0 0 0 0 0 0
0 0 0 0 0 0 0 0 0 0 5261 1 1 1 1 1 1 1 1 1 1 1 1 1 1 5283 1 1 1 1 1 1 5 1 1 1 1 1 1 1 1 1 1 1 5 1 1 1 1 1 1 1 5283 1 1 1 1 1 1 1 88 88 1 1 1 1 5260 0 5253 5252 5259 0 0 0 0 0 0 0 0 0
0 0 0 0 0 0 0 0 0 0 5261 1 1 2 1 2 1 1 1 1 1 1 2 1 1 5283 1 4 1 2 1 1 1 1 1 1 1 1 1 1 1 1 1 1 1 4 1 1 1 1 1 1 5283 1 1 1 2 1 4 1 1 1 1 1 1 2 1 5252 1 1 5260 0 0 0 0 0 0 0 0 0
0 0 0 0 0 0 0 0 0 0 5261 1 2 1 1 1 1 2 1 1 5 1 1 1 1 5283 1 1 1 1 1 1 2 1 1 1 5 4 1 5275 5282 5282 5282 5271 1 1 1 1 4 1 1 5 5283 1 1 1 2 2 4 1 2 2 1 1 2 2 2 1 1 1 1 5252 5259 0 0 0 0 0 0 0
0 0 0 0 0 0 0 0 0 0 5261 1 1 1 1 1 1 1 1 1 1 1 1 1 1 5283 1 1 1 1 2 1 1 1 1 4 1 1 1 5283 1 1 1 5283 1 1 2 1 1 1 1 1 5283 1 1 2 2 2 2 4 2 2 2 2 2 2 2 2 2 2 1 1 5260 0 0 0 0 0 0 0
0 0 0 0 0 0 0 0 0 0 5261 1 1 1 5255 5255 5255 5255 5255 5255 5255 5255 1 1 1 5283 1 1 1 1 1 1 1 1 1 1 1 1 1 5283 1 1 1 5283 1 1 1 1 1 1 1 1 5283 1 1 1 2 2 2 2 2 2 2 2 2 2 2 2 2 2 2 1 5260 0 0 0 0 0 0 0
0 0 0 0 0 0 0 0 0 5253 1 1 1 5257 0 0 0 0 0 0 0 0 5256 1 1 5274 5282 5282 5282 5282 5282 5282 5270 5282 5282 5282 5282 5282 5282 5279 1 2 1 5283 1 1 1 1 1 1 1 1 5283 1 1 1 2 2 2 2 2 2 2 2 2 2 2 2 2 2 2 1 5260 0 0 0 0 0 0 0
0 0 0 0 0 0 0 0 0 5261 1 1 5257 0 0 0 0 0 0 0 0 0 0 5256 1 1 1 1 1 1 1 1 5283 1 1 1 1 1 1 5283 1 2 1 5283 1 2 1 1 1 1 5 1 5283 1 1 5 2 2 2 2 2 2 2 2 2 2 2 2 2 2 1 1 1 5259 0 0 0 0 0 0
0 0 0 0 0 0 0 0 5253 1 1 5257 0 0 0 0 0 0 0 0 0 0 0 0 5256 1 1 1 1 2 1 1 5283 1 1 2 1 1 1 5283 1 1 1 5283 1 1 1 4 5 1 1 1 5274 5271 1 2 2 2 2 2 2 2 2 2 2 2 2 2 2 2 1 1 1 5260 0 0 0 0 0 0
0 0 0 0 0 0 0 0 5261 1 5260 0 0 0 0 0 0 0 0 0 0 0 0 0 0 5261 1 2 1 1 1 1 5283 1 2 1 1 1 1 5283 5 1 1 5283 1 1 1 1 1 1 1 1 1 5283 1 2 2 2 2 2 2 2 2 2 2 2 2 2 2 1 1 1 1 5260 0 0 0 0 0 0
0 0 0 0 0 5253 5252 5252 1 1 5260 0 0 0 0 0 0 0 0 0 0 0 0 0 0 5261 1 1 1 1 1 1 5283 1 1 1 1 1 1 5283 1 4 1 5283 1 2 1 1 1 2 1 1 1 5283 1 1 2 2 2 2 2 2 2 2 2 2 2 2 2 1 1 1 1 5260 0 0 0 0 0 0
0 0 0 0 0 5261 1 1 1 1 5260 0 0 0 0 0 0 0 0 0 0 0 0 0 0 5261 1 2 1 5 1 1 5283 1 1 1 5 5 1 5283 1 1 1 5283 1 1 1 2 1 1 1 2 1 5283 1 2 2 2 2 2 2 2 2 2 2 2 5 2 2 2 2 1 1 1 5252 5252 5259 0 0 0
0 0 0 0 0 5256 1 1 1 1 5260 0 0 0 0 0 0 0 0 0 0 0 0 0 0 5261 1 1 1 1 2 1 5283 1 5 1 1 1 1 5283 1 1 1 5283 1 1 1 1 1 1 1 1 1 5283 1 1 2 2 2 2 2 2 2 2 2 5 2 2 2 2 1 1 1 5 1 1 5260 0 0 0
0 0 0 0 0 0 5261 1 1 1 5260 0 0 0 0 0 0 0 0 0 0 0 0 0 5253 1 1 1 1 1 1 1 5283 1 5 1 1 2 1 5283 1 2 1 5283 1 1 1 1 1 1 1 1 1 5283 1 1 1 2 2 2 2 2 2 2 2 2 2 2 2 2 1 1 1 1 1 1 5257 0 0 0
0 0 0 0 0 0 5261 1 2 1 1 5259 0 0 0 0 0 0 0 0 0 0 0 5253 1 1 5275 5282 5282 5282 5282 5282 5281 1 1 1 1 1 1 5283 1 1 1 5274 5282 5282 5282 5282 5282 5282 5282 5282 5282 5279 1 1 2 2 2 2 2 2 2 2 2 2 2 2 2 2 2 1 1 1 1 5260 0 0 0 0
0 0 0 0 0 0 5261 1 1 1 1 1 5252 5259 0 0 0 0 0 0 0 0 5253 1 1 1 5283 1 5 1 1 1 1 1 1 2 1 1 1 5283 1 1 1 1 1 1 1 1 1 1 1 1 1 5283 1 2 2 2 2 2 2 2 4 2 2 2 2 2 2 2 2 1 1 1 1 5260 0 0 0 0
0 0 0 5253 5252 5252 1 1 1 1 1 1 1 1 5252 5252 5252 5252 5252 5252 5252 5252 1 1 1 1 5283 1 1 1 1 1 1 5 1 1 1 1 1 5283 1 1 2 1 1 1 1 1 2 1 2 1 1 5283 1 1 2 1 1 2 2 1 1 5 1 1 2 2 1 1 2 1 1 1 1 5260 0 0 0 0
0 0 0 5261 1 1 1 1 1 1 1 1 1 1 1 1 1 1 1 1 1 1 2 1 1 1 5283 1 1 2 2 2 1 1 1 1 2 1 1 5283 1 2 1 1 2 1 4 1 1 2 1 1 1 5283 1 1 1 1 1 1 1 1 1 1 1 1 1 5 1 1 1 1 1 1 1 5260 0 0 0 0
0 0 0 5256 1 1 1 1 1 1 1 5 1 1 1 1 1 1 1 1 1 1 1 1 1 5 5283 1 1 1 1 1 1 1 1 1 1 1 1 5283 1 1 1 1 1 1 1 1 1 1 1 5 1 5274 5282 5282 5282 5282 5282 5282 5282 5282 5282 5282 5282 5282 5271 1 1 1 1 1 1 1 1 1 5259 0 0 0
0 0 0 0 5261 1 1 1 1 2 1 1 1 1 1 1 1 4 1 2 1 1 1 1 1 1 5283 1 1 1 1 1 2 1 1 1 1 1 1 5283 1 1 1 2 1 1 1 1 5 1 1 5 1 1 1 1 1 1 1 1 1 1 1 1 1 1 5283 1 1 2 2 1 5 1 1 1 5260 0 0 0
0 0 0 0 5261 4 1 1 2 2 1 1 1 2 1 1 1 4 1 1 1 4 1 1 1 1 5283 1 1 1 1 1 1 1 1 1 5 1 8 8 8 1 1 1 1 1 1 1 5 1 1 1 1 2 1 1 1 1 1 1 1 1 2 1 1 1 5283 1 1 1 1 1 1 1 1 1 5260 0 0 0
0 0 0 0 5261 1 1 2 2 2 2 2 2 2 2 1 1 1 1 1 1 1 1 1 1 1 5278 5282 5282 5282 5282 5282 5282 5282 5282 5282 5282 5282 8 8 8 5282 5282 5282 5282 5282 5282 5282 5282 5282 5282 5271 1 1 1 1 1 1 1 1 1 1 1 1 1 4 5283 1 1 1 1 1 1 2 1 1 5260 0 0 0
0 0 0 5253 1 1 2 2 2 2 2 2 2 2 2 2 1 1 1 1 1 1 1 2 1 1 5283 1 1 1 5 1 1 1 1 1 1 1 8 8 8 1 1 1 1 1 1 1 1 5 1 5283 1 1 2 2 1 1 1 1 2 1 1 1 1 1 5283 1 1 1 1 1 1 1 1 1 5260 0 0 0
0 0 0 5261 1 1 2 2 2 2 2 2 2 2 2 1 1 1 1 1 1 1 1 1 1 1 5283 1 1 1 1 1 1 2 1 1 1 1 8 8 55 1 1 1 1 1 1 2 1 1 1 5283 1 1 1 1 1 2 1 1 1 1 2 1 1 1 5283 1 1 4 1 2 1 1 1 1 5260 0 0 0
0 0 0 5261 1 4 1 2 2 2 2 2 2 2 2 4 1 5275 5282 5282 5282 5282 5282 5270 5282 5282 5281 1 1 4 1 1 1 1 1 1 1 1 99 5283 1 1 2 1 1 2 1 1 1 1 1 5283 1 1 1 1 2 1 1 2 1 1 1 1 1 1 5283 1 1 1 1 1 1 1 5 1 5260 0 0 0
0 0 0 5261 1 1 2 2 5 4 2 2 2 2 2 1 1 5283 1 1 1 1 4 5283 1 1 1 1 1 1 1 1 1 2 1 5 1 1 1 5283 1 5 1 1 1 1 1 1 1 1 1 5283 1 1 1 1 1 1 1 1 1 1 1 1 5 1 5283 1 1 2 1 1 1 1 1 1 5260 0 0 0
0 0 0 5261 5 1 1 2 2 2 2 2 2 2 2 2 1 5283 1 2 1 1 1 5283 1 1 1 1 1 4 1 2 1 2 1 1 1 2 1 5283 1 1 1 1 5275 5282 5282 5282 5282 5282 5282 5280 5282 5282 5282 5282 5282 5282 5282 5282 5282 5282 5282 5282 5282 5282 5279 1 1 1 1 5 1 1 1 1 5260 0 0 0
0 0 0 5261 1 1 1 2 5 2 2 2 2 2 2 1 1 5283 1 2 1 1 1 5283 1 1 2 1 1 1 1 1 1 1 1 1 1 1 1 5283 1 1 1 1 5283 1 1 1 1 1 1 1 1 1 1 1 1 1 1 1 1 1 1 1 1 1 5283 5 1 1 1 1 1 1 1 1 5260 0 0 0
0 0 0 5261 1 1 2 1 2 2 1 1 2 2 1 1 1 5283 1 1 1 1 1 5283 5 1 1 1 2 1 1 2 1 1 1 1 1 2 1 5283 1 1 2 1 5283 1 1 1 5 1 1 1 1 1 1 2 1 1 1 1 1 4 1 1 2 1 5283 1 1 1 1 1 1 1 1 1 5260 0 0 0
0 0 0 5261 1 1 1 1 1 1 1 1 1 4 1 1 1 5283 1 2 2 1 1 5283 1 1 1 1 1 1 1 1 1 1 1 2 1 1 1 5283 1 1 1 1 5283 1 1 1 5 1 1 1 5 5 1 1 1 1 1 2 1 1 1 2 1 1 5283 1 1 2 1 1 1 5 1 1 5260 0 0 0
0 0 0 5261 1 1 1 1 1 1 1 1 1 5 1 1 1 5283 1 1 1 1 1 5283 1 1 1 1 5 1 1 1 1 2 1 1 1 1 1 5283 1 2 2 1 5283 4 1 1 1 1 1 4 1 1 1 1 1 4 1 1 1 1 1 1 1 1 5283 1 1 1 1 1 1 1 1 1 5260 0 0 0
0 0 0 5261 1 1 1 1 1 1 1 1 1 1 1 1 1 5283 1 1 1 2 1 5283 1 1 1 1 1 1 1 1 1 1 1 1 1 1 1 5283 1 1 1 1 5283 1 1 1 1 1 1 4 2 1 1 1 1 1 1 1 1 1 1 1 1 1 5283 1 1 2 1 2 1 1 1 1 1 5259 0 0
0 0 0 5261 1 1 4 5 1 1 1 1 1 5275 5282 5282 5282 5281 1 1 1 1 1 5274 5282 5282 5282 5282 5282 5282 5282 5282 5282 5282 5282 5271 1 1 1 5283 1 1 2 1 5283 1 5 1 1 1 5 1 1 1 1 1 2 1 5 5275 5282 5282 5282 5282 5282 5282 5281 5 1 1 1 1 1 1 1 1 1 5260 0 0
0 0 0 5256 1 1 1 1 1 1 1 5 1 5283 1 1 1 1 1 2 1 2 1 1 1 1 1 1 1 1 1 1 1 5 1 5278 5282 5282 5282 5281 1 1 1 1 5283 1 1 1 2 1 1 1 1 1 2 1 1 1 1 5283 1 1 1 1 1 1 1 1 1 1 1 1 2 1 1 1 5255 5257 0 0
0 0 0 0 5261 1 2 1 2 1 1 1 1 5283 1 1 5 1 1 1 1 1 1 1 1 1 1 4 1 1 2 1 1 1 1 5283 1 1 1 1 1 1 1 1 5283 1 1 1 1 1 1 1 1 1 1 1 1 1 1 5283 1 2 1 1 1 1 1 1 1 5 1 1 1 1 1 5260 0 0 0 0
0 0 0 0 5261 1 1 1 1 1 1 5275 5282 5281 1 1 1 1 1 1 1 1 1 1 1 1 1 1 1 2 1 1 1 1 1 5283 1 2 1 1 5 1 1 5 5283 1 1 2 1 1 4 1 2 1 1 1 1 1 1 5283 1 1 1 1 1 2 1 1 1 1 5 1 1 1 1 5260 0 0 0 0
0 0 0 0 5261 1 1 1 5 1 1 5283 1 1 5 1 2 1 1 5255 5255 5255 5255 5255 5255 1 1 2 1 1 1 1 2 2 1 5283 1 1 1 1 1 1 1 1 5283 1 1 1 1 1 1 1 1 1 4 1 2 1 1 5283 1 1 1 2 1 1 1 1 1 1 1 1 1 2 1 1 5259 0 0 0
0 0 0 0 5256 1 1 2 1 4 1 5283 1 1 1 1 1 1 5257 0 0 0 0 0 0 5256 1 1 1 1 1 4 1 1 1 5283 1 1 1 5275 5282 5282 5282 5282 5281 1 2 2 1 1 2 1 1 1 1 1 1 1 1 5283 1 1 1 1 5 1 1 1 1 1 1 1 1 1 1 1 5260 0 0 0
0 0 0 0 0 5256 1 1 1 4 1 5283 1 2 2 5 1 5260 0 0 0 0 0 0 0 0 5256 1 1 1 1 1 1 1 1 5283 1 1 1 5283 1 1 1 1 1 1 1 1 1 1 1 1 2 1 1 1 1 1 1 5283 4 1 5 1 1 1 1 1 1 1 2 1 1 1 1 5255 5257 0 0 0
0 0 0 0 0 0 5261 1 1 1 4 5283 1 2 1 1 1 5257 0 0 0 0 0 0 0 0 0 5261 1 1 1 1 1 1 1 5283 1 2 1 5283 1 1 1 2 1 1 1 1 5 1 5 1 1 1 1 1 1 1 1 5283 1 5 1 1 1 5 1 2 1 1 1 1 1 1 5257 0 0 0 0 0
0 0 0 0 0 0 5261 1 1 1 1 5283 1 1 5 1 5260 0 0 0 0 0 0 0 0 0 0 5261 1 5275 5282 5282 5282 5282 5282 5281 1 1 1 5283 1 1 5 1 1 5275 5282 5282 5282 5282 5282 5282 5282 5282 5282 5282 5282 5282 5282 5281 1 1 1 1 1 1 1 1 1 1 1 1 1 5260 0 0 0 0 0 0
0 0 0 0 0 0 5261 1 4 1 1 5283 1 1 1 1 1 5259 0 0 0 0 0 0 0 0 0 5261 1 5283 1 1 1 1 1 1 1 1 1 5283 1 4 1 1 1 5283 1 1 92 1 1 1 1 1 1 1 1 1 1 1 1 1 1 2 1 1 1 1 1 1 1 1 1 5260 0 0 0 0 0 0
0 0 0 0 0 0 5261 1 1 1 1 5283 1 1 1 1 1 5260 0 0 0 0 0 0 0 0 5253 1 1 5283 1 1 1 2 1 2 1 1 1 5283 1 2 1 1 1 5283 1 1 1 1 2 2 1 1 2 2 1 1 2 5 1 1 2 2 2 1 1 1 1 1 2 1 1 5260 0 0 0 0 0 0
0 0 0 0 0 0 5256 1 1 2 1 5274 5282 5282 5282 5271 1 1 5258 0 0 0 0 0 0 0 5256 1 1 5283 1 1 1 1 1 1 1 1 1 5283 1 1 1 1 1 5283 1 1 1 2 2 2 2 2 2 2 2 4 2 2 2 2 2 2 2 2 4 1 1 1 1 1 1 5260 0 0 0 0 0 0
0 0 0 0 0 0 0 5261 1 1 2 1 1 1 1 5283 1 5260 0 0 0 0 0 0 0 0 0 5261 1 5283 1 5 1 1 1 1 1 4 1 5283 1 1 1 2 1 5283 1 4 2 2 2 2 2 2 2 2 2 2 2 2 2 2 2 2 2 2 2 2 1 1 1 1 1 5260 0 0 0 0 0 0
0 0 0 0 0 0 0 5256 5255 1 1 1 1 1 1 5283 1 5260 0 0 0 0 0 0 0 0 5253 1 1 5283 1 1 2 1 1 1 1 1 1 5283 1 1 1 1 1 5283 1 1 1 2 2 2 2 2 2 2 2 2 2 2 2 2 2 2 2 2 2 2 1 1 5 1 1 5257 0 0 0 0 0 0
0 0 0 0 0 0 0 0 0 5261 1 1 1 1 1 5283 1 1 5259 0 0 0 0 0 0 5253 1 1 1 5283 1 1 1 1 2 1 1 5 1 5283 1 1 2 1 1 5283 1 1 5 2 2 2 2 2 2 2 2 2 2 2 2 2 2 2 2 2 2 1 1 5255 5255 5255 5257 0 0 0 0 0 0 0
0 0 0 0 0 0 0 0 0 5261 1 1 1 4 1 5283 5 1 1 5252 5252 5252 5252 5252 5252 1 1 2 1 5283 1 1 1 1 1 1 1 1 4 5283 1 2 1 1 1 5283 1 1 1 2 2 2 2 2 2 2 2 2 2 2 2 2 2 2 2 2 2 5 5260 0 0 0 0 0 0 0 0 0 0 0
0 0 0 0 0 0 0 0 0 5256 5255 5255 5255 1 1 5283 4 2 1 1 1 1 1 1 1 1 2 1 1 5283 1 1 1 1 1 1 1 5 1 5283 1 5 1 1 1 5283 1 1 1 1 2 2 2 2 2 2 2 2 2 2 2 2 2 2 2 2 2 2 1 5259 0 0 0 0 0 0 0 0 0 0
0 0 0 0 0 0 0 0 0 0 0 0 0 5261 1 5283 1 1 1 1 1 1 1 1 1 1 1 1 1 5283 1 1 2 1 1 1 1 1 1 5283 1 1 1 1 1 5283 1 1 1 5 2 2 2 2 2 2 2 2 2 2 2 2 2 2 2 2 2 2 1 5260 0 0 0 0 0 0 0 0 0 0
0 0 0 0 0 0 0 0 0 0 0 0 0 5261 1 5274 5282 5282 5282 5282 5282 5282 5282 5282 5282 5282 5282 5282 5282 5281 1 1 1 1 1 1 5275 5282 5282 5281 5 1 1 5 1 5283 1 1 1 4 2 2 2 2 2 2 2 2 2 2 2 2 2 2 2 2 2 1 5255 5257 0 0 0 0 0 0 0 0 0 0
0 0 0 0 0 0 0 0 0 0 0 0 0 5261 1 1 1 1 1 1 1 1 1 1 1 1 1 1 1 1 1 1 1 1 1 5 5283 1 1 1 1 5 1 1 1 5283 1 1 1 1 4 2 2 2 2 2 2 2 2 2 2 2 2 1 1 2 1 5260 0 0 0 0 0 0 0 0 0 0 0 0
0 0 0 0 0 0 0 0 0 0 0 0 0 5256 5255 5255 5255 1 1 2 2 1 1 1 1 1 2 1 1 1 2 1 1 2 1 1 5283 1 2 1 1 1 1 1 1 5283 1 1 1 1 1 1 1 1 2 2 4 1 1 2 2 2 1 1 1 1 5255 5257 0 0 0 0 0 0 0 0 0 0 0 0
0 0 0 0 0 0 0 0 0 0 0 0 0 0 0 0 0 5261 1 1 1 1 1 1 4 1 1 1 1 1 1 1 1 93 1 1 5283 1 1 1 1 1 1 2 1 5278 5282 5282 5282 5282 5282 5282 5271 1 1 1 1 1 1 1 1 1 1 1 1 5257 0 0 0 0 0 0 0 0 0 0 0 0 0 0
0 0 0 0 0 0 0 0 0 0 0 0 0 0 0 0 0 5256 5255 1 5 1 2 1 1 4 1 1 1 1 1 1 1 1 1 1 5283 1 1 2 1 1 1 1 1 5283 1 1 1 4 1 1 5283 1 1 1 1 1 1 1 1 1 5255 5255 5257 0 0 0 0 0 0 0 0 0 0 0 0 0 0 0
0 0 0 0 0 0 0 0 0 0 0 0 0 0 0 0 0 0 0 5256 1 4 1 1 1 1 1 2 1 4 1 4 1 1 1 5 5283 1 1 1 1 1 4 5 1 5283 1 2 1 1 2 1 5283 5 1 1 1 2 1 1 1 5260 0 0 0 0 0 0 0 0 0 0 0 0 0 0 0 0 0 0
0 0 0 0 0 0 0 0 0 0 0 0 0 0 0 0 0 0 0 0 5256 5255 1 1 2 1 1 1 1 1 2 1 1 2 1 1 5283 1 2 1 1 1 1 5 1 5283 1 1 1 1 1 1 5283 1 1 2 1 1 1 1 1 5260 0 0 0 0 0 0 0 0 0 0 0 0 0 0 0 0 0 0
0 0 0 0 0 0 0 0 0 0 0 0 0 0 0 0 0 0 0 0 0 0 5261 1 4 1 1 1 1 1 1 1 1 1 1 1 5283 1 1 1 4 4 2 1 5 5283 1 1 1 2 1 1 5283 1 1 1 1 1 1 5255 5255 5257 0 0 0 0 0 0 0 0 0 0 0 0 0 0 0 0 0 0
0 0 0 0 0 0 0 0 0 0 0 0 0 0 0 0 0 0 0 0 0 0 5261 1 1 1 1 1 5255 1 1 1 1 1 1 1 5283 1 1 1 1 1 1 1 1 5283 1 1 1 1 1 1 5283 1 5255 1 1 1 5257 0 0 0 0 0 0 0 0 0 0 0 0 0 0 0 0 0 0 0 0 0
0 0 0 0 0 0 0 0 0 0 0 0 0 0 0 0 0 0 0 0 0 0 5256 5255 1 5 1 5260 0 5256 1 1 5 1 2 1 5274 5282 5282 5282 5282 5282 5282 5282 5282 5280 5282 5282 5282 5282 5282 5282 5281 5260 0 5256 5255 5257 0 0 0 0 0 0 0 0 0 0 0 0 0 0 0 0 0 0 0 0 0 0
0 0 0 0 0 0 0 0 0 0 0 0 0 0 0 0 0 0 0 0 0 0 0 0 5256 1 1 5260 0 0 5256 5255 5255 1 1 1 1 1 1 1 1 1 1 4 1 1 1 1 1 1 1 1 1 5260 0 0 0 0 0 0 0 0 0 0 0 0 0 0 0 0 0 0 0 0 0 0 0 0 0 0
0 0 0 0 0 0 0 0 0 0 0 0 0 0 0 0 0 0 0 0 0 0 0 0 0 5256 5255 5257 0 0 0 0 0 5261 1 1 1 1 1 5 1 1 1 1 1 1 1 1 1 5255 5255 5255 5255 5257 0 0 0 0 0 0 0 0 0 0 0 0 0 0 0 0 0 0 0 0 0 0 0 0 0 0
0 0 0 0 0 0 0 0 0 0 0 0 0 0 0 0 0 0 0 0 0 0 0 0 0 0 0 0 0 0 0 0 0 5256 5255 5255 5255 5255 5255 5255 5255 5255 5255 5255 5255 5255 5255 5255 5257 0 0 0 0 0 0 0 0 0 0 0 0 0 0 0 0 0 0 0 0 0 0 0 0 0 0 0 0 0 0 0
0 0 0 0 0 0 0 0 0 0 0 0 0 0 0 0 0 0 0 0 0 0 0 0 0 0 0 0 0 0 0 0 0 0 0 0 0 0 0 0 0 0 0 0 0 0 0 0 0 0 0 0 0 0 0 0 0 0 0 0 0 0 0 0 0 0 0 0 0 0 0 0 0 0 0 0 0 0 0 0
0 0 0 0 0 0 0 0 0 0 0 0 0 0 0 0 0 0 0 0 0 0 0 0 0 0 0 0 0 0 0 0 0 0 0 0 0 0 0 0 0 0 0 0 0 0 0 0 0 0 0 0 0 0 0 0 0 0 0 0 0 0 0 0 0 0 0 0 0 0 0 0 0 0 0 0 0 0 0 0