-0 0 0 0 0 0 0 0 0 0 0 0 0 0 0 0 0 0 0 0 0 0 0 0 0 0 0 0 0 0 0 0 0 0 0 0 0 0 0 0 0 0 0 0 0 0 0 0 0 0 0 0 0 0 0 0 0 0 0 0 0 0 0 0 0 0 0 0 0 0 0 0 0 0 0 0 0 0 0 0
0 0 0 0 0 0 0 0 0 0 0 0 0 0 0 0 0 0 0 0 0 0 0 0 0 0 0 0 0 0 0 0 0 0 0 0 0 0 0 0 0 0 0 0 0 0 0 0 0 0 0 0 0 0 0 0 0 0 0 0 0 0 0 0 0 0 0 0 0 0 0 0 0 0 0 0 0 0 0 0
0 0 0 0 0 0 0 0 0 0 0 0 0 0 0 0 0 0 0 0 0 0 0 0 0 0 0 0 0 0 0 0 0 0 0 0 0 0 5253 5252 5252 5252 5252 5259 0 0 0 0 0 0 0 0 0 0 0 0 0 0 0 0 0 0 0 0 0 0 0 0 0 0 0 0 0 0 0 0 0 0 0 0
0 0 0 0 0 0 0 0 0 0 0 0 0 0 0 0 0 0 0 0 0 0 0 0 0 0 0 0 0 0 5253 5252 5252 5252 5252 5259 0 0 5261 1 1 1 1 1 5259 0 0 0 0 0 5253 5252 5259 0 0 0 0 0 0 0 0 0 0 0 0 0 0 0 0 0 0 0 0 0 0 0 0 0 0 0
0 0 0 0 0 0 0 0 0 0 0 0 0 0 0 0 0 0 0 0 0 0 0 0 0 0 0 5253 5252 5252 1 2 1 1 1 2 5252 5252 1 1 1 1 1 1 5260 0 5253 5252 5252 5252 1 1 5260 0 0 0 0 0 0 0 0 0 0 0 0 0 0 0 0 0 0 0 0 0 0 0 0 0 0 0
0 0 0 0 0 0 0 0 0 0 0 0 0 0 0 0 0 0 0 0 0 0 0 0 5253 5252 5252 1 2 2 1 1 1 1 1 1 1 1 1 5 1 1 1 1 1 5252 1 1 2 1 2 1 5260 0 0 0 0 0 0 0 0 0 0 0 0 0 0 0 0 0 0 0 0 0 0 0 0 0 0 0
0 0 0 0 0 0 0 0 0 0 0 0 0 0 0 0 0 0 0 0 0 0 0 0 5261 2 1 2 2 2 1 1 1 1 1 3 1 1 1 1 2 1 1 1 1 1 2 1 1 1 1 1 1 5252 5252 5252 5259 0 0 0 0 0 0 0 0 0 0 0 0 0 0 0 0 0 0 0 0 0 0 0
0 0 0 0 0 0 0 0 0 0 0 0 0 0 0 0 0 0 0 0 0 0 5253 5252 1 2 2 1 1 1 1 3 3 3 3 3 1 2 3 1 1 1 2 5 1 2 1 1 1 1 1 1 2 2 1 1 1 5259 0 0 0 0 0 0 0 0 0 0 0 0 0 0 0 0 0 0 0 0 0 0
0 0 0 0 0 0 0 0 0 0 0 0 0 0 0 0 0 0 0 0 5253 5252 1 2 1 1 1 1 3 1 2 1 3 1 3 3 3 3 3 1 4 1 1 2 1 1 1 1 1 2 1 1 1 1 1 1 1 1 5252 5252 5252 5252 5259 0 0 0 0 0 0 0 0 0 0 0 0 0 0 0 0 0
0 0 0 0 0 0 0 0 0 0 0 0 0 0 0 0 0 0 5253 5252 1 2 1 1 1 1 1 1 3 1 4 5 1 1 1 1 3 1 1 1 5 1 1 1 1 2 1 1 1 1 1 1 2 1 2 1 2 1 1 2 1 2 5260 0 0 0 0 0 0 0 0 0 0 0 0 0 0 0 0 0
0 0 0 0 0 0 0 0 0 0 0 0 0 0 0 0 0 5253 1 2 1 2 1 1 3 1 1 1 3 1 3 3 3 3 3 3 3 1 4 3 3 1 4 1 3 3 3 1 1 1 1 1 1 1 3 1 1 1 2 1 1 1 1 5259 0 0 0 0 0 0 0 0 0 0 0 0 0 0 0 0
0 0 0 0 0 0 0 0 0 0 0 0 0 0 0 0 0 5261 2 2 1 1 1 1 3 1 4 1 3 1 3 2 1 3 1 1 1 1 1 1 3 2 4 1 1 1 3 2 1 1 4 3 3 3 1 3 1 1 1 1 1 1 1 5260 0 0 0 0 0 0 0 0 0 0 0 0 0 0 0 0
0 0 0 0 0 0 0 0 0 0 0 0 0 0 0 0 5253 1 1 1 1 1 3 3 3 3 3 3 3 3 3 1 3 1 5 1 3 1 3 1 3 3 3 3 3 1 4 1 1 3 3 1 1 4 3 1 1 1 1 3 1 1 3 5260 0 0 0 0 0 0 0 0 0 0 0 0 0 0 0 0
0 0 0 0 0 0 0 0 0 0 0 0 0 0 5253 5252 1 1 1 4 1 1 1 3 3 4 1 1 3 3 3 1 1 1 1 1 1 1 3 1 3 1 3 1 3 1 1 1 4 1 2 3 1 3 3 3 1 3 1 1 1 1 3 1 5252 5259 0 0 0 0 0 0 0 0 0 0 0 0 0 0
0 0 0 0 0 0 0 0 0 0 0 0 0 0 5261 1 3 3 3 1 3 1 3 3 3 1 3 1 3 3 3 1 3 3 3 1 3 2 5 3 3 1 3 1 5 1 3 3 1 1 2 2 1 1 1 3 4 1 3 3 3 3 3 3 3 1 5259 0 0 0 0 0 0 0 0 0 0 0 0 0
0 0 0 0 0 0 0 0 0 0 5253 5252 5252 5252 1 1 3 1 4 1 1 1 3 1 3 1 1 3 1 3 3 3 1 1 3 1 1 4 1 1 3 1 3 1 3 1 5 3 1 1 3 3 1 5 3 1 1 1 3 1 1 3 1 2 4 1 5260 0 0 0 0 0 0 0 0 0 0 0 0 0
0 0 0 0 0 0 0 0 0 0 5261 1 1 1 3 3 3 1 1 3 3 3 3 3 3 1 3 3 3 1 3 1 4 1 3 3 3 3 3 3 3 3 3 1 4 1 1 1 2 1 3 3 1 3 3 1 3 3 3 3 3 1 1 1 3 1 5260 0 5253 5252 5259 0 0 0 0 0 0 0 0 0
0 0 0 0 0 0 0 0 0 0 5261 1 1 1 3 3 3 1 1 1 3 1 1 1 3 3 3 5 3 1 3 1 1 2 3 1 3 3 3 1 1 1 3 1 3 5 1 1 3 3 3 1 1 1 1 3 3 1 5 1 3 2 1 1 3 3 1 5252 1 2 5260 0 0 0 0 0 0 0 0 0
0 0 0 0 0 0 0 0 0 0 5261 1 2 1 3 3 3 3 3 1 4 3 3 3 3 3 3 1 3 3 3 1 3 3 3 1 4 5 3 3 3 1 3 3 3 1 3 1 5 1 1 4 4 3 3 1 3 3 5 1 3 3 3 3 3 1 1 1 1 1 1 5252 5259 0 0 0 0 0 0 0
0 0 0 0 0 0 0 0 0 0 5261 2 1 1 1 1 1 1 3 1 1 1 1 1 4 1 3 1 3 3 1 1 1 1 2 5 3 1 3 1 1 3 3 1 3 1 3 1 1 1 1 1 3 1 1 3 3 1 1 5 3 1 3 1 3 1 2 1 1 1 2 2 5260 0 0 0 0 0 0 0
0 0 0 0 0 0 0 0 0 0 5261 1 3 1 1 1 2 1 3 1 3 3 2 1 3 1 3 3 3 3 3 3 3 3 3 1 2 1 3 1 3 3 3 3 3 3 3 3 3 1 3 1 3 3 3 1 3 1 3 3 3 1 3 1 3 3 3 3 3 1 1 1 5260 0 0 0 0 0 0 0
0 0 0 0 0 0 0 0 0 5253 1 3 3 1 1 3 3 1 3 1 1 1 1 1 1 2 1 1 3 1 3 1 3 2 3 1 1 1 3 1 3 3 1 1 3 3 1 3 3 1 1 1 3 1 1 3 3 1 1 3 1 1 3 3 1 1 3 1 1 1 1 1 5260 0 0 0 0 0 0 0
0 0 0 0 0 0 0 0 0 5261 3 3 3 3 3 4 3 1 3 1 3 1 3 3 3 3 3 3 3 1 3 1 2 1 3 3 3 3 3 1 3 3 3 1 3 1 3 1 3 2 4 1 3 3 3 4 3 3 3 1 3 3 3 3 3 3 3 3 3 1 3 1 1 5259 0 0 0 0 0 0
0 0 0 0 0 0 0 0 5253 1 2 1 3 1 3 1 1 3 3 3 3 3 1 3 3 1 3 1 1 2 3 3 1 3 3 2 3 1 1 1 3 1 3 3 1 1 3 5 4 1 1 3 1 5 3 3 1 1 1 1 1 1 3 3 3 2 1 3 1 1 3 1 1 5260 0 0 0 0 0 0
0 0 0 0 0 0 0 0 5261 2 1 1 3 3 3 1 3 3 3 1 3 3 3 1 3 3 3 1 3 3 3 3 3 3 3 3 3 3 3 1 4 3 3 3 3 3 3 1 3 1 3 1 3 3 3 3 3 3 3 1 3 1 3 3 3 1 3 1 3 3 1 1 1 5260 0 0 0 0 0 0
0 0 0 0 0 5253 5252 5252 1 1 1 1 3 1 3 3 1 3 3 3 3 3 1 2 3 1 4 1 3 3 1 1 3 1 3 1 1 1 3 1 1 5 3 1 3 1 1 3 1 3 3 1 1 1 3 1 3 2 1 1 1 3 1 3 3 3 1 3 1 1 1 1 1 5260 0 0 0 0 0 0
0 0 0 0 0 5261 2 2 3 3 3 3 3 1 3 3 3 1 3 3 3 3 3 3 3 1 4 3 3 4 3 1 3 1 3 2 4 4 3 3 3 3 3 2 3 1 3 1 3 1 3 1 2 3 3 1 3 3 3 3 3 3 3 3 3 1 4 1 1 2 1 3 3 1 5252 5252 5259 0 0 0
0 0 0 0 0 5256 1 1 3 1 3 1 3 1 3 1 3 1 3 3 3 1 1 1 3 1 1 3 1 3 1 1 1 1 4 3 1 2 1 3 1 1 3 1 3 1 1 3 1 1 3 1 1 1 2 1 1 3 1 3 1 1 3 1 3 4 1 2 3 1 1 1 1 4 1 2 5260 0 0 0
0 0 0 0 0 0 5261 2 1 1 3 4 3 3 3 1 3 1 3 1 3 3 3 3 3 3 3 3 3 3 3 1 3 3 4 1 3 1 2 1 3 1 3 2 3 1 3 3 3 3 3 1 3 3 3 3 3 3 3 3 3 3 3 3 3 3 3 1 1 1 1 3 3 1 1 1 5257 0 0 0
0 0 0 0 0 0 5261 1 1 1 3 1 5 1 1 3 3 3 3 4 3 3 1 1 1 2 3 3 3 3 3 1 3 3 1 1 1 1 1 3 3 1 3 1 3 1 3 3 3 1 3 1 1 1 1 1 3 1 1 1 3 1 3 1 2 1 1 1 1 3 1 1 3 1 1 5260 0 0 0 0
0 0 0 0 0 0 5261 3 3 1 3 5 3 3 3 2 3 1 3 3 3 1 3 1 3 3 3 1 4 1 3 3 3 3 3 1 3 3 3 3 3 3 3 3 3 3 3 3 3 1 3 3 3 1 3 1 3 3 3 1 2 1 5 3 3 3 3 1 3 3 3 3 3 3 3 5260 0 0 0 0
0 0 0 5253 5252 5252 1 1 1 3 3 3 3 1 3 1 1 1 3 1 5 1 1 3 1 1 1 1 1 1 3 3 3 4 3 1 2 1 1 1 1 1 1 1 3 2 3 2 1 1 3 1 1 5 3 3 3 1 3 3 1 1 3 4 3 1 1 1 1 1 3 1 3 1 3 5260 0 0 0 0
0 0 0 5261 2 2 3 3 3 3 3 3 3 1 3 1 3 3 3 2 3 1 3 1 3 3 3 1 3 3 3 1 3 1 3 3 3 1 3 3 3 3 3 3 3 3 5 1 3 1 3 3 3 3 3 3 3 3 3 3 3 1 3 1 3 1 3 4 3 3 3 3 3 1 1 5260 0 0 0 0
0 0 0 5256 1 1 3 1 1 1 3 4 1 1 3 3 3 1 1 2 1 3 3 1 1 4 3 1 3 1 3 1 1 3 1 1 1 1 1 1 3 1 1 3 3 3 3 1 3 1 1 4 1 1 1 1 1 1 3 2 1 3 1 1 3 3 3 1 3 3 1 3 1 1 1 1 5259 0 0 0
0 0 0 0 5261 1 3 1 3 1 3 3 3 3 3 3 3 5 3 2 3 1 3 3 3 3 3 3 3 2 3 1 3 2 3 1 3 1 3 1 3 3 3 1 3 1 3 3 4 2 3 4 3 1 3 3 3 1 3 1 3 1 3 3 3 3 3 3 3 3 3 1 4 1 2 1 5260 0 0 0
0 0 0 0 5261 5 1 1 1 1 1 1 3 1 1 1 3 5 3 2 1 5 3 1 3 1 3 1 1 1 3 1 3 3 1 1 4 1 3 1 3 1 1 1 3 1 3 1 4 1 1 1 1 3 3 1 3 1 3 1 3 1 3 1 3 1 3 2 3 2 3 1 1 1 1 1 5260 0 0 0
0 0 0 0 5261 1 1 1 3 1 3 1 3 3 3 3 3 3 3 2 3 1 3 3 3 3 3 1 3 1 3 1 3 5 1 1 3 1 3 3 3 1 3 4 3 3 3 3 3 3 3 1 3 3 3 1 3 3 3 3 3 3 3 1 3 5 3 3 3 3 3 1 3 1 1 1 5260 0 0 0
0 0 0 5253 1 1 1 1 1 3 1 3 3 2 3 1 1 1 1 2 3 1 1 3 3 1 3 1 1 1 4 1 3 3 1 2 1 1 3 1 3 1 3 1 3 1 2 3 1 4 1 1 3 1 1 1 1 3 2 3 3 2 3 3 3 1 1 1 3 1 2 3 3 1 2 1 5260 0 0 0
0 0 0 5261 1 1 3 3 1 1 3 1 3 3 3 3 3 1 3 3 3 3 3 3 3 1 3 3 3 3 3 3 3 1 3 1 3 3 3 1 3 3 3 3 3 1 3 1 3 1 3 1 3 3 3 1 3 1 3 1 3 3 3 1 3 3 3 3 3 5 2 3 1 1 1 1 5260 0 0 0
0 0 0 5261 1 5 1 1 3 1 1 1 1 1 3 5 3 1 3 1 1 1 3 3 1 1 3 1 3 5 2 3 3 1 1 3 3 99 3 3 3 3 1 3 3 3 1 1 1 3 3 1 1 1 3 1 3 1 3 1 1 1 3 1 1 1 1 1 3 1 1 3 3 1 4 1 5260 0 0 0
0 0 0 5261 1 1 1 1 4 5 1 1 3 3 3 1 3 1 3 1 3 1 5 3 3 3 3 3 3 2 3 3 3 1 3 4 3 3 3 1 3 4 2 1 3 1 3 1 3 1 3 3 3 3 3 3 3 3 3 3 3 3 3 1 4 3 3 3 3 1 3 2 3 3 2 1 5260 0 0 0
0 0 0 5261 4 1 1 1 3 1 1 1 3 1 3 1 1 1 3 3 3 1 1 1 1 1 1 1 1 5 3 1 3 1 1 1 1 1 3 1 1 1 1 1 3 1 3 3 1 2 3 1 1 1 1 1 5 3 1 3 3 3 1 1 1 1 3 3 3 1 1 4 3 1 1 2 5260 0 0 0
0 0 0 5261 1 2 1 1 4 1 2 3 3 1 3 3 3 1 3 3 3 3 3 3 3 3 3 1 3 1 3 1 3 3 3 3 3 3 3 3 3 3 3 1 3 3 3 3 3 1 3 3 3 1 2 1 3 1 3 3 3 3 3 1 3 3 3 4 3 3 3 1 3 3 1 2 5260 0 0 0
0 0 0 5261 2 1 3 1 3 3 3 1 3 3 1 3 1 1 3 1 3 1 1 3 4 2 1 3 3 1 3 2 1 1 1 1 1 3 3 3 3 1 1 1 3 3 1 3 4 1 3 1 3 1 1 1 3 1 3 1 1 5 1 3 3 1 3 1 3 1 3 1 1 1 1 2 5260 0 0 0
0 0 0 5261 1 2 1 1 3 2 3 3 3 5 3 1 3 1 3 3 3 3 3 3 3 3 3 3 3 3 3 1 3 3 3 3 3 3 3 3 3 1 3 3 3 1 3 1 4 1 3 3 4 4 1 1 3 3 3 2 3 1 3 1 3 1 3 3 3 3 3 1 3 4 1 1 5260 0 0 0
0 0 0 5261 1 1 1 1 3 3 3 2 3 4 2 1 3 1 3 1 3 3 3 1 1 3 3 3 4 1 3 1 1 1 3 1 1 1 1 1 3 1 1 3 3 5 1 1 3 3 3 5 1 3 1 1 1 5 1 1 1 1 1 1 3 1 1 3 1 1 3 1 3 1 1 1 5260 0 0 0
0 0 0 5261 1 1 2 1 3 3 3 3 3 3 3 3 3 3 3 1 3 3 3 1 3 3 3 1 3 3 3 3 3 1 3 2 3 3 3 1 3 1 3 3 3 3 3 3 3 1 3 5 3 2 3 1 3 1 3 3 3 3 3 3 3 3 3 3 3 3 3 1 3 3 3 1 2 5259 0 0
0 0 0 5261 1 1 5 4 3 3 1 1 1 3 2 1 3 3 1 1 3 3 1 1 3 1 1 3 1 2 3 1 3 1 3 3 3 1 1 1 3 1 3 2 5 1 4 1 3 3 4 3 1 1 1 3 3 1 4 3 3 3 2 1 1 1 1 4 1 3 3 1 3 2 3 1 1 5260 0 0
0 0 0 5256 1 2 3 3 3 1 3 4 3 3 3 3 3 1 3 1 3 1 3 1 3 1 3 1 3 3 3 3 3 4 3 3 3 1 3 1 3 3 3 1 3 1 3 1 3 3 3 1 3 3 3 3 3 3 3 3 3 3 3 1 3 3 3 1 3 3 3 3 3 2 3 1 5255 5257 0 0
0 0 0 0 5261 1 3 1 3 1 1 3 3 1 3 1 4 3 1 2 1 3 3 2 1 1 1 5 3 1 1 1 3 1 3 1 3 1 1 1 1 3 3 1 1 3 3 1 1 1 3 1 1 3 1 3 3 1 3 1 1 1 3 3 1 3 3 1 1 4 1 1 1 1 1 5260 0 0 0 0
0 0 0 0 5261 1 3 1 1 1 3 1 3 3 3 3 3 3 3 1 4 1 3 3 3 1 3 1 3 1 3 1 3 1 3 1 3 3 3 1 4 1 3 4 3 3 2 1 2 1 5 1 3 3 3 3 3 1 3 1 3 3 3 3 3 3 3 1 3 2 4 3 1 1 2 5260 0 0 0 0
0 0 0 0 5261 1 1 1 4 1 1 1 3 1 4 1 1 3 3 3 1 1 3 1 1 3 1 1 3 2 1 3 1 1 1 3 3 3 3 3 1 1 3 1 1 2 3 1 1 1 1 1 3 3 5 1 3 3 3 3 1 3 1 1 1 3 3 1 3 1 1 1 1 1 1 1 5259 0 0 0
0 0 0 0 5256 1 2 1 1 5 1 3 3 3 3 1 3 1 3 3 3 1 3 3 3 1 3 1 3 2 3 5 3 1 3 3 3 1 3 1 3 3 3 3 3 3 3 2 2 1 3 1 3 3 3 3 3 3 3 2 3 3 3 1 4 1 3 3 3 1 3 1 2 1 1 1 5260 0 0 0
0 0 0 0 0 5256 1 1 1 5 1 3 3 1 1 4 1 1 3 1 3 3 3 1 3 1 1 1 3 1 3 1 3 1 3 1 1 3 1 3 1 1 1 3 1 1 3 1 1 1 1 1 1 3 3 1 3 1 3 1 5 1 4 3 1 3 1 1 3 1 1 2 1 1 1 5255 5257 0 0 0
0 0 0 0 0 0 5261 1 1 1 5 1 3 3 3 3 3 1 3 1 3 3 3 1 3 3 3 3 3 1 3 3 3 3 3 1 3 3 3 3 3 1 3 1 3 3 3 1 4 3 4 1 3 3 3 3 2 1 3 3 3 4 3 3 3 4 3 3 3 1 3 1 1 1 5257 0 0 0 0 0
0 0 0 0 0 0 5261 2 1 1 3 1 3 2 4 2 3 1 1 1 3 3 3 3 1 1 3 1 1 1 3 3 3 3 3 1 1 3 3 3 3 1 4 3 3 1 1 1 1 3 3 1 1 1 3 1 3 1 1 1 3 3 3 1 3 1 1 1 1 1 1 3 1 5260 0 0 0 0 0 0
0 0 0 0 0 0 5261 2 5 2 3 3 3 3 3 3 3 3 3 3 3 3 3 1 3 1 3 1 3 3 3 1 3 3 3 3 3 3 3 1 3 5 3 1 3 3 3 3 3 1 3 3 3 3 3 1 2 3 3 1 3 3 3 1 3 3 3 1 3 3 1 1 2 5260 0 0 0 0 0 0
0 0 0 0 0 0 5261 1 2 1 3 1 3 3 3 1 1 1 1 3 1 1 3 1 1 1 3 1 1 1 1 1 3 1 3 1 3 1 1 2 3 1 3 3 3 1 3 1 3 3 1 1 3 1 1 1 1 3 1 4 3 3 1 3 3 1 1 1 3 1 1 1 1 5260 0 0 0 0 0 0
0 0 0 0 0 0 5256 1 1 1 1 1 3 3 3 3 3 1 3 3 3 1 3 1 3 1 3 3 3 2 3 3 3 3 3 3 3 1 3 1 3 1 3 3 3 3 3 3 3 3 3 3 3 3 3 1 3 5 3 3 3 2 3 2 3 1 5 1 3 1 2 1 1 5260 0 0 0 0 0 0
0 0 0 0 0 0 0 5261 1 2 1 1 3 3 3 1 3 4 1 1 3 2 3 3 3 1 3 1 4 1 1 4 1 1 1 1 1 5 3 1 3 1 3 3 1 1 3 5 3 1 1 1 3 3 1 1 1 3 3 1 3 3 1 3 3 1 3 1 3 1 1 1 2 5260 0 0 0 0 0 0
0 0 0 0 0 0 0 5256 5255 1 1 2 3 3 3 4 1 1 3 1 3 1 3 3 3 3 3 1 5 3 3 1 3 3 3 1 3 1 3 3 3 3 3 3 3 3 3 1 3 1 3 1 3 3 3 3 3 1 3 3 3 3 3 3 3 3 3 3 3 1 4 1 1 5257 0 0 0 0 0 0
0 0 0 0 0 0 0 0 0 5261 2 2 2 1 1 1 3 1 3 2 3 1 3 1 2 3 3 1 3 1 3 3 3 1 3 1 1 4 1 3 3 3 1 1 1 2 3 3 4 1 1 1 1 1 3 1 3 1 3 1 1 1 1 3 3 1 1 3 1 5255 5255 5255 5257 0 0 0 0 0 0 0
0 0 0 0 0 0 0 0 0 5261 1 1 1 5 1 1 4 2 3 3 3 3 3 1 3 3 3 1 4 1 3 3 3 3 3 3 3 1 5 1 3 3 3 3 3 1 3 1 3 1 1 1 2 1 3 3 3 3 3 3 3 1 3 1 3 1 3 4 5260 0 0 0 0 0 0 0 0 0 0 0
0 0 0 0 0 0 0 0 0 5256 5255 5255 5255 1 1 1 5 1 3 1 3 4 2 3 1 2 3 1 1 1 1 1 3 3 3 1 3 4 1 1 3 4 1 1 3 3 3 1 1 3 2 1 1 1 3 1 1 1 3 1 3 1 1 3 1 1 1 1 1 5259 0 0 0 0 0 0 0 0 0 0
0 0 0 0 0 0 0 0 0 0 0 0 0 5261 1 1 1 1 3 1 3 3 3 1 3 1 3 3 3 1 3 3 3 1 3 1 3 1 3 1 3 1 3 1 3 1 3 1 3 4 1 1 3 1 3 3 3 1 3 1 2 1 1 1 1 1 1 1 2 5260 0 0 0 0 0 0 0 0 0 0
0 0 0 0 0 0 0 0 0 0 0 0 0 5261 2 1 1 2 1 1 1 3 3 1 1 1 3 1 1 1 3 1 3 1 1 1 3 3 1 3 4 1 1 4 3 1 1 1 3 5 1 1 1 1 3 1 1 3 3 1 1 2 1 2 1 1 2 1 5255 5257 0 0 0 0 0 0 0 0 0 0
0 0 0 0 0 0 0 0 0 0 0 0 0 5261 1 2 1 1 1 2 3 1 3 3 3 1 3 3 3 1 4 1 3 3 3 4 2 1 2 1 3 4 3 1 3 3 3 1 3 1 5 2 1 1 3 1 1 1 3 3 3 1 2 1 1 1 1 5260 0 0 0 0 0 0 0 0 0 0 0 0
0 0 0 0 0 0 0 0 0 0 0 0 0 5256 5255 5255 5255 1 1 1 3 1 3 1 1 1 3 1 3 1 3 1 3 1 3 1 3 2 1 1 1 1 3 1 3 3 3 2 3 1 1 1 1 5 1 1 5 1 3 1 3 1 2 1 1 1 5255 5257 0 0 0 0 0 0 0 0 0 0 0 0
0 0 0 0 0 0 0 0 0 0 0 0 0 0 0 0 0 5261 1 1 1 3 3 1 5 1 3 3 3 3 3 3 3 1 3 3 3 3 3 3 3 3 3 3 3 3 3 3 3 3 3 3 3 1 1 3 2 1 1 1 1 1 1 1 1 5257 0 0 0 0 0 0 0 0 0 0 0 0 0 0
0 0 0 0 0 0 0 0 0 0 0 0 0 0 0 0 0 5256 5255 1 4 1 1 3 1 5 3 3 1 1 3 3 1 3 3 1 3 1 3 1 3 1 3 1 1 3 3 3 1 5 3 3 1 1 3 1 1 1 1 1 1 1 5255 5255 5257 0 0 0 0 0 0 0 0 0 0 0 0 0 0 0
0 0 0 0 0 0 0 0 0 0 0 0 0 0 0 0 0 0 0 5256 1 5 2 1 2 1 3 3 3 5 3 5 3 1 3 4 3 3 3 1 3 3 5 4 3 1 3 1 3 3 3 3 3 4 1 1 1 1 1 2 2 5260 0 0 0 0 0 0 0 0 0 0 0 0 0 0 0 0 0 0
0 0 0 0 0 0 0 0 0 0 0 0 0 0 0 0 0 0 0 0 5256 5255 1 1 2 1 3 1 3 1 1 1 1 1 3 1 3 1 1 1 1 1 3 4 1 2 3 3 3 1 1 3 1 3 1 2 2 1 1 1 1 5260 0 0 0 0 0 0 0 0 0 0 0 0 0 0 0 0 0 0
0 0 0 0 0 0 0 0 0 0 0 0 0 0 0 0 0 0 0 0 0 0 5261 1 5 1 3 1 3 3 3 3 3 3 3 3 3 3 3 3 5 5 3 1 4 1 3 3 3 3 3 1 1 3 1 1 1 1 1 5255 5255 5257 0 0 0 0 0 0 0 0 0 0 0 0 0 0 0 0 0 0
0 0 0 0 0 0 0 0 0 0 0 0 0 0 0 0 0 0 0 0 0 0 5261 2 1 1 2 1 5255 1 3 1 1 1 2 1 3 1 3 1 1 1 1 3 1 1 3 3 1 1 1 1 1 1 5255 1 1 2 5257 0 0 0 0 0 0 0 0 0 0 0 0 0 0 0 0 0 0 0 0 0
0 0 0 0 0 0 0 0 0 0 0 0 0 0 0 0 0 0 0 0 0 0 5256 5255 1 4 1 5260 0 5256 1 1 4 1 1 1 3 1 3 3 3 3 3 1 1 3 3 1 1 1 1 1 1 5260 0 5256 5255 5257 0 0 0 0 0 0 0 0 0 0 0 0 0 0 0 0 0 0 0 0 0 0
0 0 0 0 0 0 0 0 0 0 0 0 0 0 0 0 0 0 0 0 0 0 0 0 5256 1 2 5260 0 0 5256 5255 5255 1 1 2 1 1 1 1 3 1 1 5 1 3 3 2 1 1 2 1 1 5260 0 0 0 0 0 0 0 0 0 0 0 0 0 0 0 0 0 0 0 0 0 0 0 0 0 0
0 0 0 0 0 0 0 0 0 0 0 0 0 0 0 0 0 0 0 0 0 0 0 0 0 5256 5255 5257 0 0 0 0 0 5261 2 1 1 1 1 4 3 3 1 1 2 3 3 1 1 5255 5255 5255 5255 5257 0 0 0 0 0 0 0 0 0 0 0 0 0 0 0 0 0 0 0 0 0 0 0 0 0 0
0 0 0 0 0 0 0 0 0 0 0 0 0 0 0 0 0 0 0 0 0 0 0 0 0 0 0 0 0 0 0 0 0 5256 5255 5255 5255 5255 5255 5255 5255 5255 5255 5255 5255 5255 5255 5255 5257 0 0 0 0 0 0 0 0 0 0 0 0 0 0 0 0 0 0 0 0 0 0 0 0 0 0 0 0 0 0 0
0 0 0 0 0 0 0 0 0 0 0 0 0 0 0 0 0 0 0 0 0 0 0 0 0 0 0 0 0 0 0 0 0 0 0 0 0 0 0 0 0 0 0 0 0 0 0 0 0 0 0 0 0 0 0 0 0 0 0 0 0 0 0 0 0 0 0 0 0 0 0 0 0 0 0 0 0 0 0 0
0 0 0 0 0 0 0 0 0 0 0 0 0 0 0 0 0 0 0 0 0 0 0 0 0 0 0 0 0 0 0 0 0 0 0 0 0 0 0 0 0 0 0 0 0 0 0 0 0 0 0 0 0 0 0 0 0 0 0 0 0 0 0 0 0 0 0 0 0 0 0 0 0 0 0 0 0 0 0 0